1111111111
10CE000001
1000000001
100C000001
10000C0001
10X0000001
1000000XP1
100000C001
1000000001
1111111111
