11111111111
1E100C00001
1P0000100C1
11111111111
