1111111111
100C000001
1C000E0P01
1000000C01
1111111111