1111111111
100C000001
1C00000P01
1E00000C11
1111111111