1111111111111111111
100C000011100C001C1
1C000000000C0F10001
1001000C1P10FEF0001
10000F0000000000001
1000C00011100000C01
1111111111111111111