11111111111111111111
100C000001100C000001
1C000000P00C0F000001
1000000C0110FEF00C01
10000000000000000001
1000C0C0011000000C01
11111111111111111111