11111111111111111111111111111111111111111111111111111111111111111111
1000000000000000F00000000C000100000000000010C00010110100000000000001
1000000000000000F000000000000010000000000010000010110000000000000001
1000000000000000F00000000C00000100000C00000100001C1100000000C0000001
100000000000000000000C0000000C001000000000100000100000000000C0000001
1000000P000F0000F000000000000F000100000000000000000000000000E0000001
1000000000000000F00000000C000C0000F0C00000000000001101000000F0000001
1000000000000000CF00000000000C000000C00000000000101101000000F0000001
1000000000000000F00000000C0000000000F00000000000100001000000F0000001
100000000F00000000000000000000000000C1000010000010C00100000010000001
10C0000000000000F0000000000000000000001000100000101101000000F0000001
11111111111111111111111111111111111111111111111111111111111111111111