1111111111
10CE000001
1000000001
100C000001
10000C0001
1000000001
10000000P1
10E000C001
10000000E1
1111111111
