1111111111
10CE000001
1000000001
100C010001
10001C1001
1000010001
10000000P1
100000C001
1000000001
1111111111
