1111111111
10CE000001
100000000
100C000001
10000C0001
1000000001
10000000P1
100000C001
1000000001
1111111111
