1111111111
100E000001
1000000001
1000000001
1000000001
1000000001
10000000P1
1000000001
1000000001
1111111111
