111111111
0CE000001
000000001
00C000001
0000C0001
000000001
0000000P1
00000C001
000000001
111111111
