1111111111
10CE000001
1000000001
100C000001
10000C0001
1000000001
10000000C1
100000C001
1000000001
1111111111
