111111111
10CE00000
100000000
100C00000
10000C000
100000000
10000000P
100000C00
100000000
111111111
