1111111111
10CE000001
10L0000001
100C000001
10000C0001
1000P00001
10000000P1
100000C001
10000X0001
1111111111
