11111111111111111111
100C000001100C000001
1C000000PF0C000E0001
1000000C011000000C01
11111111111111111111