1111111111
100C000001
1C000E0001
1P00000C01
1111111110