11111111111111111111
100C000001100C000001
1C000000000C000E0001
1P00000C011000000C01
1111111111111111111