1111111111
100C000001
1C000E0001
1P0000C011
1000C00001
00C00E0001
10P0000C01
1111111111