1111111111
100C000000
1C000E0000
1P0000C010
1000C00000
10C00E0000
10P0000C00
1111111111